1111111111111111
1P00000100000011
10C0000110000E11
1000V00000111111
1000000111C00111
1111111111111111
