111111111
1P0000011
10C000E11
1000V0110
100000111
111111111
